0 F 0 0 0 0 0 0
0 0 0 F 0 0 0 0
0 0 0 F 0 0 0 0
0 0 0 0 0 0 0 F
0 0 0 0 0 0 0 F
0 0 0 0 0 0 0 F
0 0 0 0 0 0 0 0
0 0 0 0 0 0 0 0
